а	a
б	b
в	v
г	g
д	d
е	‘e
ё	‘o
ж	zh
з	z
и	i
й	j
к	k
л	l
м	m
н	n
о	o
п	p
р	r
с	s
т	t
у	u
ф	f
х	h
ц	ts
ч	ch
ш	sh
щ	sch
ъ	‘’
ы	i
ь	'
э	e
ю	‘u
я	‘a
А	A
Б	B
В	V
Г	G
Д	D
Е	‘E
Ё	‘O
Ж	ZH
З	Z
И	I
Й	J
К	K
Л	L
М	M
Н	N
О	O
П	P
Р	R
С	S
Т	T
У	U
Ф	F
Х	H
Ц	TS
Ч	CH
Ш	SH
Щ	SCH
Ъ	‘’
Ы	I
Ь	'
Э	E
Ю	‘U
Я	‘A
